2 3 3 4 5
3 4 4 1 4
2 1 0 2 1
4 2 1 3 4
3 1 2 2 3